0000000000000000000000000000000000000000000000000000000000000000000000000
0000000000000000000000000000000000000000000000000000000000000000000000000
0000000000000000000000000000000000000000000000000000000000000000000000000
3000000000000000000000000000000000000000000000000000000000000000000000003
3000000000000000000000000000000000000000000000000000000000000000000000003
3000000000000000000000000000000000000000000000000000000000000000000000003
3000000000000000000000000000000000000000000000000000000000000000000000003
3000000000000000000000000000000000000000000000000000000000000000000000003
3000000000000000000000000000000000000000000000000000000000000000000000003
3000000000000000000000000000000000000000000000000000000000000000000000003
3000000000000000000000000000000000000000000000000000000000000000000000003
3000000000000000000000000000000000000000000000000000000000000000000000003
3000000000000000000000222222000000000000000000000000000000000000000000003
3000000000000000000000000110000000000000000000000000000000000000000000003
3000000000000000000000000000000000000000000022444200000000000000000000003
3000000000000000000000000000022244422200000001111000000000000000000000003
3000000000000000000000000000000000000000000000000000000000000000000000003
3000000000000000000000000000000000000000000000000000000000000000000000003
3000000000000000000000002222222244422222222000002222000000000000000000003
3000000000000000000000001111111155511111111000011111000000000000000000003
3000000000000000000000000111111155511111110000001100000000000000000000003
3000000000000000000000000001111155511111000000001000000000000000000000003
3000000000000000000000000000001155511000000000001000000000000000000000003
3000000000000000000000000000000000000000000000000000000000000000000000003
3000000000000000000000000000000000000000000000000000000000000000000000003
3000000000000000000000000000000000000000000000000000000000000000000000003
3000000000000000000000000000000022200000000000000000000000000000000000003
3000000000000000000000000000000000000000000000000000000000000000000000003
3000000000000000000000000000000000000000000000000000000000000000000000003
3000000000000000000000000000000000000000000000000000000000000000000000003
3000000000000000000000000000000000000000000000000000000000000000000000003
3333333333333333333333333333333333333333333333333333333333333333333333333